33331111111111111111
32551111111111111111
33111211111211111111
14111114111111111111
11111111221111111111
11111111111111111111
11111111111111111111
11111111111111111111
11111111111111111111
11111114111111111111
11123333333211111111
11112333333331111111
11112334333321111111
11112333333321123333
11112333332221112333