6178181111
7436768131
8567876678
6667221781
6826221478
7661131566
8636111867
7876867766