333311111111111111111111111111
322211111111111111111111122222
331112111112111111111111111111
141111141111111111111111111111
111111112211111111111141111111
111111111111111111111111111111
111111111111111111111111111111
111111111111111111111111111111
111111111111111111111111111111
111111141111111111111111111111
111111111111111111111141111111
111111111111111111111111111111
111111141111111111111111111111
111111111111112333333321111111
111111111111112333333331111111
111132223111112334333321111111
111133333111112333333321111111
111111111111112333332221111111
111111111111111111111111111111
111111111111111111111111111111